____________________
|                  |
|                  |
|                  |
|                  |
|                  |
|                  |
|                  |
|                  |
|__________________|